 NO texturestexturestexturestexturestexturestexturestexturestexturestexturestexturestexturestexturestexturestexturestexturestexturestexturestexturestexturestexturestexturestexturestexturestexturestexturestexturestexturestexturestexturmtexturestexturestextures/texturestexturestexturestexturestexturestexturestexturestexturestexturestexturestexturestexturestexturestexturestexturestexturestexturestexturestexturestexturestexturestexturestexturestexturestexturestexturestexturestexturestexturmtexturestexturestextures/texturestexturestexturestexturestexturestexturestexturestexturestexturestexturestexturestexturestexturestexturestexturestexturestexturestexturestexturestexturestexturestexturestexturestexturestexturestexturestexturestexturestexturmtexturestexturestext.png

 SO texturestexturestexturestexturestexturestexturestexturestexturestexturestexturestexturestexturestexturestexturestexturestexturestexturestexturestexturestexturestexturestexturestexturestexturestexturestexturestexturestexturestexturmtexturestexturestextures/texturestexturestexturestexturestexturestexturestexturestexturestexturestexturestexturestexturestexturestexturestexturestexturestexturestexturestexturestexturestexturestexturestexturestexturestexturestexturestexturestexturestexturmtexturestexturestextures/wood
      WE        texturestexturestexturestexturestexturestexturestexturestexturestexturestexturestexturestexturestexturestexturestexturestexturestexturestexturestexturestexturestexturestexturestexturestexturestexturestexturestexturestexturestexturmtexturestexturestextures/texturestexturestexturestexturestexturestexturestexturestexturestexturestexturestexturestexturestexturestexturestexturestexturestexturestexturestexturestexturestexturestexturestexturestexturestexturestexturestexturestexturestexturmtexturestexturestextures/wood


              EA texturestexturestexturestexturestexturestexturestexturestexturestexturestexturestexturestexturestexturestexturestexturestexturestexturestexturestexturestexturestexturestexturestexturestexturestexturestexturestexturestexturestexturmtexturestexturestextures/texturestexturestexturestexturestexturestexturestexturestexturestexturestexturestexturestexturestexturestexturestexturestexturestexturestexturestexturestexturestexturestexturestexturestexturestexturestexturestexturestexturestexturmtexturestexturestextures/wood



   F 61, 5, 5




   C        56,              30,    10




1111      111111
                     11111111111111111111
   11111111111111111111111
   11111111111111111111111111111
1111110000011000000000001111101
    1111000001110000W10000001111
1111000000001000000000011111
    1111110010111000011101001
1111100000001010001110111111111111
1111111111111111111111111111111
             1111111111111111 111111111111111   
1111111111111111111111111111111
1111111111111111111111111111111
1111111  111111111111 111111111111
 1111111111111111111111111111111 
111111111111111111 11111



























