NO  execution/textures/_the_scream.png
SO      execution/textures/tile3.png
      WE        execution/textures/stone_bricks.png
              EA       execution/textures/wood.png
F                          220,100,0







    C          225,30,0

1111111111111111111111
1000100000000000000001
100ED00000000000000001
1000100000000000000001
1000000000000000000001
1000000000000000000001
1111111111111111111111