NO     execution/textures/beamskin.pngds
SO      execution/textures/beamskin3.png  
      WE        execution/textures/gratewall.png  
              EA       execution/textures/steelwall6.png  
F 6, 5, 66





    C          225, 30, 5

   1111 
     111111111111111111111111
11111100000110000000000011
111110000111000010000001
1111000000000000000000011111
    1111110010111000011101001
11111000E0001010001110111111111111
1111111111111111111111111111111
1111111111111111 111111111111111   
1111111111111111111111111111111
1111111111111111111111111111111
1111111  111111111111 111111111111
1111111111111111111111111111111
1111111111111111111111111111111




