NO  execution/textures/_the_scream.png
SO      execution/textures/tile3.png
      WE        execution/textures/stone_bricks.png
              EA       execution/textures/wood.png
F                          220,100,0







    C          225,30,0

   1111
     111111111111111111111111
11111100000110000000000011
1111100001110000100000011
111100000000000000000001D111
    1111110010111000011101001
11111000E0001010001110111111111111
1111111111111111111111111111111
1111111111111111111111111111111
1111111111111111111111111111111
1111111111111111111111111111111
1111111111111111111111111111111
1111111111111111111111111111111
1111111111111111111111111111111
